6 6 6 6 6 6 6 6 6 6 6 6 6 6 6 6 6 6 6 6 6 6 6 6 6 6 6 6 6 6 6 6 6 6 6 6 6 6 6 6 6 6 6 6 6 6 6 6 6 6 6 6 6 6 6 6 6 6 6 6 6 6
6 0 0 0 0 0 0 0 0 0 0 0 0 0 0 0 0 0 0 0 0 0 0 0 0 0 0 0 0 0 0 0 0 0 0 0 0 0 0 0 0 0 0 0 0 0 0 0 0 0 0 0 0 0 0 0 0 0 0 0 0 6
6 0 0 0 0 0 0 0 0 0 0 0 0 0 0 0 0 0 0 0 0 0 0 0 0 0 0 0 0 0 0 0 0 0 0 0 0 0 0 0 0 0 0 0 0 0 0 0 0 0 0 0 0 0 0 0 0 0 0 0 0 6
6 0 0 0 0 0 0 0 0 0 0 0 0 0 0 0 0 0 0 0 0 0 0 0 0 0 0 0 0 0 0 0 0 0 0 0 0 0 0 0 0 0 0 0 0 0 0 0 0 0 0 0 0 0 0 0 0 0 0 0 0 6
6 0 0 0 5 12 5 0 0 0 6 6 6 6 6 6 6 6 6 6 6 6 6 6 6 0 0 0 6 6 6 0 0 0 6 6 6 0 0 0 6 6 6 6 6 6 6 6 6 6 6 6 0 0 0 5 12 5 0 0 0 6
6 0 0 0 13 0 13 0 0 0 0 0 6 0 0 0 0 0 0 0 0 0 0 0 6 0 0 0 6 0 6 0 0 0 6 0 6 0 0 0 6 0 0 0 0 0 0 0 0 6 0 0 0 0 0 13 0 13 0 0 0 6
6 0 0 0 5 12 5 0 0 0 6 6 6 0 0 0 0 0 6 6 6 6 6 6 6 0 0 0 6 0 6 0 0 0 6 0 6 0 0 0 6 6 6 6 6 6 6 0 0 6 6 6 0 0 0 5 12 5 0 0 0 6
6 0 0 0 0 0 0 0 0 0 0 0 6 0 0 0 0 0 6 0 0 0 0 0 0 0 0 0 6 0 6 0 0 0 6 0 6 0 0 0 0 0 0 0 0 0 6 0 0 6 0 0 0 0 0 0 0 0 0 0 0 6
6 0 0 0 0 0 0 0 0 0 6 6 6 0 0 0 0 0 6 0 0 0 0 0 0 0 0 0 6 0 6 0 0 0 6 0 6 0 0 0 0 0 0 0 0 0 6 0 0 6 6 6 0 0 0 0 0 0 0 0 0 6
6 0 0 0 0 0 0 0 0 0 6 0 0 0 0 0 0 0 6 0 0 0 0 0 0 0 0 0 6 6 6 0 0 0 6 6 6 0 0 0 0 0 0 0 0 0 6 0 0 0 0 6 0 0 0 0 0 0 0 0 0 6
6 0 0 0 6 0 6 0 6 6 6 0 0 0 0 6 6 6 6 0 0 0 0 0 0 0 0 0 0 0 0 0 0 0 0 0 0 0 0 0 0 0 0 0 0 0 6 0 0 0 0 6 6 6 0 6 0 6 0 0 0 6
6 0 0 0 6 0 6 0 6 0 0 0 0 0 0 6 0 0 7 0 0 0 0 0 0 0 0 0 0 0 0 0 0 0 0 0 0 0 0 0 0 0 0 0 0 0 6 0 0 0 0 0 0 6 0 6 0 6 0 0 0 6
6 0 0 0 6 6 6 6 6 0 0 0 0 6 6 6 0 0 6 0 0 0 0 0 0 0 0 0 0 0 0 0 0 0 0 0 0 0 0 0 0 0 0 0 0 0 6 0 0 0 0 0 0 6 6 6 6 6 0 0 0 6
6 0 0 0 6 0 0 0 0 0 0 6 6 6 0 0 7 7 6 0 0 0 0 0 0 0 0 0 0 0 0 0 0 0 0 0 0 0 0 0 0 0 0 0 0 0 6 0 0 0 0 0 0 0 0 0 0 6 0 0 0 6
6 0 0 0 6 0 0 0 0 0 0 6 0 0 0 0 6 0 6 0 0 0 0 0 0 0 0 0 0 0 0 0 0 0 0 0 0 0 0 0 0 0 0 0 0 0 6 0 0 0 0 0 0 0 0 0 0 6 0 0 0 6
6 0 0 0 6 0 0 0 0 0 0 6 0 0 0 0 6 0 6 0 0 0 0 0 0 0 0 0 0 0 0 0 0 0 0 0 0 0 0 0 0 0 0 0 0 0 6 0 0 0 0 0 0 0 0 0 0 6 0 0 0 6
6 0 0 0 6 0 0 0 0 0 0 6 0 0 0 6 6 6 6 0 0 0 0 0 0 0 0 0 0 0 0 0 0 0 0 0 0 0 0 0 0 0 0 0 0 0 6 0 0 0 0 0 0 0 0 0 0 6 0 0 0 6
6 0 0 0 6 0 0 0 0 0 0 6 0 0 0 6 0 0 6 0 0 0 0 0 0 0 0 0 0 0 0 0 0 0 0 0 0 0 0 0 0 0 0 0 0 0 6 0 0 0 0 0 0 0 0 0 0 6 0 0 0 6
6 0 0 0 6 0 0 0 0 0 0 6 0 0 0 6 0 0 6 0 0 0 0 0 0 0 0 0 0 0 0 6 6 6 0 0 0 0 0 0 0 0 0 0 0 0 6 0 0 0 0 0 0 0 0 0 0 6 0 0 0 6
6 0 0 0 6 0 0 0 0 0 6 6 0 0 0 6 6 0 6 6 6 6 6 6 6 6 6 6 0 0 0 9 0 9 0 0 0 6 6 6 6 6 6 6 6 6 6 0 0 0 0 0 0 0 0 0 0 6 0 0 0 6
6 0 0 0 6 0 0 0 0 0 6 0 0 0 0 0 6 0 0 0 0 0 0 0 0 0 0 6 0 0 0 6 6 6 0 0 0 6 0 0 0 0 0 0 0 0 0 0 0 0 0 0 0 0 0 0 0 6 0 0 0 6
6 0 0 0 6 0 0 0 0 0 6 0 0 0 0 0 6 0 0 0 0 0 0 0 6 6 6 6 0 0 0 6 6 6 0 0 0 6 6 6 6 6 6 6 6 6 6 6 0 0 0 0 0 0 0 0 0 6 0 0 0 6
6 0 0 0 6 0 0 0 0 0 6 0 0 0 0 0 6 0 0 0 0 0 0 0 6 0 0 0 0 0 0 6 6 6 0 0 0 0 0 0 6 0 0 0 0 0 0 6 6 6 0 0 0 0 0 0 0 6 0 0 0 6
6 0 0 0 6 0 0 0 0 1 1 1 9 1 9 1 1 1 0 0 0 0 0 0 6 0 0 0 0 0 0 9 0 9 0 0 0 0 0 0 6 0 0 0 0 0 0 0 0 6 0 0 0 0 0 0 0 6 0 0 0 6
6 0 0 0 6 0 0 0 0 1 0 0 0 0 0 0 0 1 0 0 0 0 0 0 6 0 0 0 0 0 0 6 6 6 0 0 0 0 0 0 6 0 0 0 0 0 0 0 0 6 6 0 0 0 0 0 0 6 0 0 0 6
6 0 0 0 6 0 0 0 0 1 0 0 0 0 0 0 0 1 0 0 0 0 0 0 6 6 6 6 6 6 6 6 0 6 6 6 6 6 6 6 6 0 0 0 0 0 0 0 0 0 6 0 0 0 0 0 0 6 0 0 0 6
6 0 0 0 6 0 0 0 0 1 0 0 0 0 0 0 0 1 0 0 0 0 0 0 0 0 0 0 0 0 0 0 0 0 0 0 6 0 0 0 0 0 0 0 0 0 0 0 0 0 6 0 0 0 0 0 0 6 0 0 0 6
6 0 0 0 6 0 0 0 0 1 0 0 0 0 0 0 0 1 1 1 1 1 1 1 1 1 1 1 1 1 1 1 1 1 1 1 6 0 0 0 0 0 6 19 6 19 6 0 0 0 6 6 6 6 6 6 6 6 0 0 0 6
6 0 0 0 6 0 0 0 0 1 0 0 0 0 0 0 0 1 0 0 2 0 0 1 0 0 2 0 0 2 0 0 1 1 0 0 6 19 6 19 6 19 6 0 0 0 19 0 0 0 0 0 0 0 0 0 6 0 0 0 0 6
6 0 0 0 6 0 0 0 0 1 0 0 0 0 0 0 0 2 0 0 1 0 0 2 0 0 1 0 0 2 0 0 0 18 0 0 9 0 0 0 0 0 0 0 0 0 6 0 0 0 0 0 0 0 0 0 9 0 0 0 0 6
6 0 0 0 6 0 0 0 0 1 0 0 0 0 0 0 0 1 0 1 1 0 0 1 0 0 2 0 0 1 0 0 2 2 0 0 6 19 6 19 6 19 6 0 0 0 19 0 0 0 0 0 0 0 0 0 6 0 0 0 0 6
6 0 0 0 6 0 0 0 0 1 1 1 1 1 1 1 1 1 18 1 1 1 1 1 1 1 1 1 1 1 1 1 0 1 1 1 6 0 0 0 0 0 6 19 6 19 6 0 0 0 6 6 6 6 6 6 6 6 0 0 0 6
6 0 0 0 6 0 0 0 0 0 0 0 0 0 0 1 1 0 0 0 1 1 0 0 0 0 0 0 0 0 0 1 0 1 0 0 6 0 0 0 0 0 0 0 0 0 0 0 0 0 6 0 0 0 0 0 0 6 0 0 0 6
6 0 0 0 6 6 6 6 6 6 6 6 0 0 0 1 0 0 0 0 0 1 0 0 0 0 0 0 0 0 0 1 1 1 0 0 6 6 6 6 6 0 0 0 0 0 0 0 0 0 6 0 0 0 0 0 0 6 0 0 0 6
6 0 0 0 0 0 0 6 0 0 0 6 0 0 0 1 0 0 0 0 0 1 0 0 0 0 0 0 0 0 0 0 0 0 0 0 0 0 0 0 6 0 0 0 0 0 0 0 0 6 6 0 0 0 0 0 0 6 0 0 0 6
6 0 0 0 0 0 0 9 0 0 0 6 0 0 0 1 1 1 1 1 18 1 1 0 0 0 0 0 0 0 0 0 0 0 0 0 0 0 0 0 6 0 0 0 0 0 0 0 0 6 0 0 0 0 0 0 0 6 0 0 0 6
6 0 0 0 0 0 0 6 0 0 0 6 0 0 0 0 0 0 1 0 0 0 1 1 0 0 0 0 0 0 0 0 0 0 0 0 0 0 0 0 6 0 0 0 0 0 0 6 6 6 0 0 0 0 6 6 6 6 0 0 0 6
6 0 0 0 6 6 6 6 6 6 6 6 0 0 0 0 0 0 1 0 0 0 0 1 0 0 0 0 0 0 0 0 0 0 0 0 0 0 0 0 6 6 6 6 6 6 6 6 0 0 0 0 0 0 6 0 0 0 0 0 0 6
6 0 0 0 6 0 0 0 0 0 0 1 1 1 1 1 1 14 1 0 0 0 1 14 1 1 1 1 1 1 0 0 0 0 0 0 0 0 0 0 0 0 0 0 0 0 0 0 0 0 0 0 0 0 6 0 0 0 0 0 0 6
6 0 0 0 6 0 0 0 0 0 0 1 0 0 0 0 0 0 0 0 0 0 0 0 0 0 0 0 0 1 0 0 0 0 0 0 0 5 5 5 5 5 5 5 5 5 5 0 0 0 0 0 0 0 6 0 0 0 0 0 0 6
6 0 0 0 6 0 0 0 0 0 0 1 0 1 0 0 0 0 0 0 0 0 0 0 0 0 0 1 0 1 0 0 0 0 0 0 0 5 0 0 0 0 0 0 0 0 5 0 0 0 0 0 0 0 6 6 6 6 0 0 0 6
6 0 0 0 6 0 0 0 0 0 0 1 1 1 1 1 0 0 0 0 0 0 0 0 0 1 1 1 1 1 0 0 0 0 0 0 0 13 0 0 0 0 0 0 0 0 13 0 0 0 0 0 0 0 0 0 0 6 0 0 0 6
6 0 0 0 6 0 0 0 0 0 0 0 0 0 0 1 1 0 1 0 0 0 1 0 1 1 0 0 0 0 0 0 0 0 0 0 0 5 0 0 0 0 0 0 0 0 5 6 6 6 6 6 6 6 6 6 6 6 0 0 0 6
6 0 0 0 6 0 0 0 0 0 0 0 0 0 0 0 1 0 1 0 0 0 1 0 1 0 1 1 1 1 0 0 0 0 0 0 0 20 0 0 0 0 0 0 0 0 5 6 0 0 0 0 0 0 0 0 6 6 0 0 0 6
6 0 0 0 6 0 0 0 0 0 0 0 0 0 0 1 1 2 1 0 0 0 1 2 1 1 1 0 0 1 1 0 0 0 0 0 0 10 0 0 0 0 0 0 0 0 12 6 0 0 6 6 6 6 0 0 0 9 0 0 0 6
6 0 0 0 6 0 0 0 0 0 0 0 0 0 0 1 0 0 1 14 9 14 1 0 0 9 0 0 0 0 1 0 0 0 0 0 0 20 0 0 0 0 0 0 0 0 5 6 0 0 0 0 0 0 0 0 6 6 0 0 0 6
6 0 0 0 6 0 0 0 0 0 0 0 0 0 0 1 1 0 1 1 0 1 1 0 1 1 1 0 0 1 1 0 0 0 0 0 0 5 0 0 0 0 0 0 0 0 5 6 6 6 6 6 6 6 6 6 6 6 0 0 0 6
6 0 0 0 6 0 0 0 0 0 0 0 0 0 0 0 1 1 1 1 0 1 1 1 1 0 1 1 1 1 0 6 11 6 0 0 0 13 0 0 0 0 0 0 0 0 13 0 0 0 0 0 0 0 0 0 0 6 0 0 0 6
6 0 0 0 6 0 0 0 0 0 0 0 0 0 0 0 0 1 1 0 0 0 1 1 0 0 0 0 0 0 0 6 0 6 0 0 0 5 0 0 0 0 0 0 0 0 5 0 0 0 0 0 0 0 0 0 0 6 0 0 0 6
6 0 0 0 6 6 6 6 6 0 0 0 1 1 1 1 1 1 0 0 0 0 0 1 1 1 1 1 1 0 0 6 X 6 6 6 6 5 5 5 0 0 0 5 5 5 5 0 0 0 0 0 0 6 6 6 6 6 0 0 0 6
6 0 0 0 6 0 6 0 6 0 0 0 1 0 0 0 14 0 0 0 0 0 0 0 14 0 0 0 1 0 0 6 0 6 0 0 6 0 0 5 0 0 0 5 0 0 5 0 0 0 0 0 0 6 0 6 0 6 0 0 0 6
6 0 0 0 6 0 6 0 6 6 6 0 1 0 0 0 9 0 0 0 0 0 0 0 9 0 0 0 1 0 0 6 0 6 0 0 6 0 0 12 0 0 0 18 0 0 5 0 0 0 0 6 6 6 0 6 0 6 0 0 0 6
6 0 0 0 0 0 0 0 0 0 6 0 1 0 0 0 14 0 0 0 0 0 0 0 14 0 0 0 1 0 0 6 0 7 0 0 6 0 0 5 0 0 0 5 0 0 5 0 0 0 0 6 0 0 0 0 0 0 0 0 0 6
6 0 0 0 0 0 0 0 0 0 6 6 1 1 1 1 1 1 0 0 0 0 0 1 1 1 1 1 1 0 6 6 0 6 6 6 6 0 0 5 5 9 5 5 5 5 5 0 0 6 6 6 0 0 0 0 0 0 0 0 0 6
6 0 0 0 0 0 0 0 0 0 0 0 6 0 0 0 0 1 1 15 9 15 1 1 0 0 0 0 0 0 6 0 0 0 6 0 0 0 0 0 6 0 6 0 0 0 0 0 0 6 0 0 0 0 0 0 0 0 0 0 0 6
6 0 0 0 5 12 5 0 0 0 6 6 6 0 0 0 0 0 6 0 0 0 6 0 0 0 0 0 0 0 6 0 0 0 6 0 0 0 0 6 6 0 6 6 0 0 0 0 0 6 6 6 0 0 0 5 12 5 0 0 0 6
6 0 0 0 13 0 5 0 0 0 0 0 6 0 0 0 0 0 6 0 0 0 6 0 0 0 0 0 0 0 6 0 0 0 6 0 0 0 6 6 0 0 0 6 6 0 0 0 0 6 0 0 0 0 0 13 0 13 0 0 0 6
6 0 0 0 5 12 5 0 0 0 6 6 6 6 6 6 6 6 6 0 0 0 6 6 6 6 6 6 6 6 6 0 0 0 6 6 6 6 6 0 0 0 0 0 6 6 6 6 6 6 6 6 0 0 0 5 12 5 0 0 0 6
6 0 0 0 0 0 0 0 0 0 0 0 0 0 0 0 0 0 0 0 0 0 0 0 0 0 0 0 0 0 0 0 0 0 0 0 0 0 0 0 0 0 0 0 0 0 0 0 0 0 0 0 0 0 0 0 0 0 0 0 0 6
6 0 0 0 0 0 0 0 0 0 0 0 0 0 0 0 0 0 0 0 0 0 0 0 0 0 0 0 0 0 0 0 0 0 0 0 0 0 0 0 0 0 0 0 0 0 0 0 0 0 0 0 0 0 0 0 0 0 0 0 0 6
6 0 0 0 0 0 0 0 0 0 0 0 0 0 0 0 0 0 0 0 0 0 0 0 0 0 0 0 0 0 0 0 0 0 0 0 0 0 0 0 0 0 0 0 0 0 0 0 0 0 0 0 0 0 0 0 0 0 0 0 0 6
6 6 6 6 6 6 6 6 6 6 6 6 6 6 6 6 6 6 6 6 6 6 6 6 6 6 6 6 6 6 6 6 6 6 6 6 6 6 6 6 6 6 6 6 6 6 6 6 6 6 6 6 6 6 6 6 6 6 6 6 6 6