0 0 0 0 0 0 0 0 0 0 0 0 0 0 0 0 0 0 0 0 0 0 0 0 0 0 0 0 0 0 0 0 0 0 0 8 8 8 8 8 8 8 8 8 8 8 8 8 0 0 0 0 0 0 0 0 0 0 0 0 0 0 0
0 0 0 0 0 0 0 0 0 0 0 0 0 0 0 0 0 0 0 0 0 0 0 0 0 0 0 0 0 0 0 0 0 0 8 8 0 0 0 0 0 0 0 0 0 0 0 8 0 0 0 0 0 0 0 0 0 0 0 0 0 0 0
0 0 0 0 0 0 0 0 0 0 0 0 0 0 0 0 0 0 0 0 0 0 0 0 0 0 0 0 0 0 0 0 0 0 8 0 0 0 0 0 0 0 0 0 0 0 0 8 0 0 0 0 0 0 0 0 0 0 0 0 0 0 0
0 0 0 0 0 0 0 0 0 0 0 0 0 0 0 0 0 0 0 0 0 0 0 0 0 0 0 0 0 0 0 0 8 11 8 0 0 0 0 0 0 0 0 0 0 0 0 8 0 0 0 0 0 0 0 0 0 0 0 0 0 0 0
0 0 0 0 0 0 0 0 0 0 0 0 0 0 0 0 0 0 0 0 0 0 0 0 0 0 0 0 8 8 8 8 8 X 8 18 8 8 8 8 8 8 8 8 8 8 8 8 0 0 0 0 0 0 0 0 0 0 0 0 0 0 0
0 0 0 0 0 0 0 0 0 0 0 0 0 0 0 0 0 0 0 0 0 0 0 0 0 0 0 0 8 0 0 0 0 0 0 0 0 0 8 0 0 0 0 0 0 0 0 0 0 0 0 0 0 0 0 0 0 0 0 0 0 0 0
0 0 0 0 0 0 0 0 0 0 0 0 0 0 0 0 0 0 0 0 0 0 0 0 0 0 0 0 8 0 8 8 8 0 8 8 8 0 8 0 0 0 0 0 0 0 0 0 0 0 0 0 0 0 0 0 0 0 0 0 0 0 0
0 0 0 0 0 0 0 0 0 0 0 0 0 0 0 0 0 0 0 0 0 0 0 0 0 0 0 0 8 0 22 0 22 0 22 0 22 0 8 0 0 0 0 0 0 0 0 0 0 0 0 0 0 0 0 0 0 0 0 0 0 0 0
0 0 0 0 0 0 0 0 0 0 0 0 0 0 0 0 0 0 0 0 0 0 0 0 8 8 8 8 8 0 8 8 8 0 8 8 8 0 8 8 8 8 8 0 0 0 0 0 0 0 0 0 0 0 0 0 0 0 0 0 0 0 0
0 0 0 0 0 0 0 0 0 0 0 0 0 0 0 0 0 0 0 0 0 0 0 0 8 0 0 0 0 0 0 0 0 0 0 0 0 0 0 0 0 0 8 0 0 0 0 0 0 0 0 0 0 0 0 0 0 0 0 0 0 0 0
0 0 0 0 0 0 0 0 0 0 0 0 0 0 0 0 0 0 0 0 0 0 0 0 8 0 8 8 8 0 8 8 8 22 8 8 8 0 8 8 8 0 8 0 0 0 0 0 0 0 0 0 0 0 0 0 0 0 0 0 0 0 0
0 0 0 0 0 0 0 0 0 0 0 0 0 0 0 0 0 0 0 0 0 0 0 0 8 0 22 0 22 0 22 0 0 0 0 0 22 0 22 0 22 0 8 0 0 0 0 0 0 0 0 0 0 0 0 0 0 0 0 0 0 0 0
0 0 0 0 0 0 0 0 0 0 0 0 0 0 0 0 0 0 0 0 8 8 8 8 8 0 8 8 8 0 8 8 8 22 8 8 8 0 8 8 8 0 8 8 8 8 8 0 0 0 0 0 0 0 0 0 0 0 0 0 0 0 0
0 0 0 0 0 0 0 0 0 0 0 0 0 0 0 0 0 0 0 0 8 0 0 0 0 0 0 0 0 0 0 0 0 0 0 0 0 0 0 0 0 0 0 0 0 0 8 0 0 0 0 0 0 0 0 0 0 0 0 0 0 0 0
0 0 0 0 0 0 0 0 0 0 0 0 0 0 0 0 0 0 0 0 8 0 8 22 8 0 8 8 8 0 8 8 8 0 8 8 8 0 8 8 8 0 8 8 8 0 8 0 0 0 0 0 0 0 0 0 0 0 0 0 0 0 0
0 0 0 0 0 0 0 0 0 0 0 0 0 0 0 0 0 0 0 0 8 0 8 0 8 0 22 0 22 0 22 0 22 0 22 0 22 0 22 0 22 0 22 0 22 0 8 0 0 0 0 0 0 0 0 0 0 0 0 0 0 0 0
0 0 0 0 0 0 0 0 0 0 0 0 0 0 0 0 8 8 8 8 8 0 8 0 8 0 8 8 8 0 8 8 8 0 8 8 8 0 8 8 8 0 8 8 8 0 8 8 8 8 8 0 0 0 0 0 0 0 0 0 0 0 0
0 0 0 0 0 0 0 0 0 0 0 0 0 0 0 0 8 0 0 0 0 0 22 0 22 0 0 0 0 0 0 0 0 0 0 0 0 0 0 0 0 0 0 0 0 0 0 0 0 0 8 0 0 0 0 0 0 0 0 0 0 0 0
0 0 0 0 0 0 0 0 0 0 0 0 0 0 0 0 8 0 8 8 8 0 8 0 8 0 8 8 8 0 8 8 8 0 8 22 8 0 8 8 8 0 8 8 8 0 8 8 8 0 8 0 0 0 0 0 0 0 0 0 0 0 0
0 0 0 0 0 0 0 0 0 0 0 0 0 0 0 0 8 0 22 0 22 0 8 0 8 0 22 0 22 0 22 0 22 0 8 0 8 0 22 0 22 0 22 0 22 0 22 0 22 0 8 0 0 0 0 0 0 0 0 0 0 0 0
0 0 0 0 0 0 0 0 0 0 0 0 8 8 8 8 8 0 8 8 8 0 8 22 8 0 8 8 8 0 8 8 8 0 8 0 8 0 8 8 8 0 8 8 8 0 8 8 8 0 8 8 8 8 8 0 0 0 0 0 0 0 0
0 0 0 0 0 0 0 0 0 0 0 0 8 0 0 0 0 0 0 0 0 0 0 0 0 0 0 0 0 0 0 0 0 0 22 0 22 0 0 0 0 0 0 0 0 0 0 0 0 0 0 0 0 0 8 0 0 0 0 0 0 0 0
0 0 0 0 0 0 0 0 0 0 0 0 8 0 8 8 8 0 8 22 8 0 8 8 8 0 8 8 8 0 8 8 8 0 8 0 8 0 8 8 8 22 8 8 8 0 8 22 8 0 8 8 8 0 8 0 0 0 0 0 0 0 0
0 0 0 0 0 0 0 0 0 0 0 0 8 0 22 0 22 0 8 0 8 0 22 0 22 0 22 0 22 0 22 0 22 0 8 0 8 0 22 0 0 0 0 0 22 0 8 0 8 0 22 0 22 0 8 0 0 0 0 0 0 0 0
0 0 0 0 0 0 0 0 8 8 8 8 8 0 8 8 8 0 8 0 8 0 8 8 8 0 8 8 8 0 8 8 8 0 8 22 8 0 8 8 8 22 8 8 8 0 8 0 8 0 8 8 8 0 8 8 8 8 8 0 0 0 0
0 0 0 0 0 0 0 0 8 0 0 0 0 0 0 0 0 0 22 0 22 0 0 0 0 0 0 0 0 0 0 0 0 0 0 0 0 0 0 0 0 0 0 0 0 0 22 0 22 0 0 0 0 0 0 0 0 0 8 0 0 0 0
0 0 0 0 0 0 0 0 8 0 8 8 8 0 8 8 8 0 8 0 8 0 8 8 8 0 8 8 8 22 8 8 8 0 8 8 8 0 8 8 8 0 8 8 8 0 8 0 8 0 8 8 8 22 8 8 8 0 8 0 0 0 0
0 0 0 0 0 0 0 0 8 0 22 0 22 0 22 0 22 0 8 0 8 0 22 0 22 0 22 0 0 0 0 0 22 0 22 0 22 0 22 0 22 0 22 0 22 0 8 0 8 0 22 0 0 0 0 0 22 0 8 0 0 0 0
0 0 0 0 8 8 8 8 8 0 8 8 8 0 8 8 8 0 8 22 8 0 8 8 8 0 8 8 8 22 8 8 8 0 8 8 8 0 8 8 8 0 8 8 8 0 8 22 8 0 8 8 8 22 8 8 8 0 8 8 8 8 8
0 0 0 0 8 0 0 0 0 0 0 0 0 0 0 0 0 0 0 0 0 0 0 0 0 0 0 0 0 0 0 0 0 0 0 0 0 0 0 0 0 0 0 0 0 0 0 0 0 0 0 0 0 0 0 0 0 0 0 0 0 0 8
0 0 0 0 8 0 8 8 8 0 8 8 8 0 8 8 8 0 8 8 8 0 8 8 8 0 8 8 8 0 8 8 8 0 8 8 8 0 8 8 8 0 8 22 8 0 8 8 8 0 8 8 8 0 8 8 8 0 8 8 8 0 8
0 0 0 0 8 0 22 0 22 0 22 0 22 0 22 0 22 0 22 0 22 0 22 0 22 0 22 0 22 0 22 0 22 0 22 0 22 0 22 0 22 0 8 0 8 0 22 0 22 0 22 0 22 0 22 0 22 0 22 0 22 0 8
8 8 8 8 8 0 8 8 8 0 8 8 8 0 8 8 8 0 8 8 8 0 8 8 8 0 8 8 8 0 8 8 8 0 8 8 8 0 8 8 8 0 8 0 8 0 8 8 8 0 8 8 8 0 8 8 8 0 8 8 8 0 8
8 0 0 0 0 0 0 0 0 0 0 0 0 0 0 0 0 0 0 0 0 0 0 0 0 0 0 0 0 0 0 0 0 0 0 0 0 0 0 0 0 0 22 0 22 0 0 0 0 0 0 0 0 0 0 0 0 0 0 0 0 0 8
8 0 8 8 8 0 8 8 8 22 8 8 8 0 8 8 8 0 8 8 8 0 8 22 8 0 8 8 8 0 8 8 8 0 8 8 8 0 8 22 8 0 8 0 8 0 8 8 8 0 8 8 8 0 8 22 8 0 8 8 8 0 8
8 0 22 0 22 0 22 0 0 0 0 0 22 0 22 0 22 0 22 0 22 0 8 0 8 0 22 0 22 0 22 0 22 0 22 0 22 0 8 0 8 0 8 0 8 0 22 0 22 0 22 0 22 0 8 0 8 0 22 0 22 0 8
8 0 8 8 8 0 8 8 8 22 8 8 8 0 8 8 8 0 8 8 8 0 8 0 8 0 8 8 8 0 8 8 8 0 8 8 8 0 8 0 8 0 8 22 8 0 8 8 8 0 8 8 8 0 8 0 8 0 8 8 8 0 8
8 0 0 0 0 0 0 0 0 0 0 0 0 0 0 0 0 0 0 0 0 0 22 0 22 0 0 0 0 0 0 0 0 0 0 0 0 0 22 0 22 0 0 0 0 0 0 0 0 0 0 0 0 0 22 0 22 0 0 0 0 0 8
8 8 8 8 8 0 8 8 8 0 8 22 8 0 8 8 8 0 8 8 8 0 8 0 8 0 8 8 8 0 8 8 8 22 8 8 8 0 8 0 8 0 8 8 8 0 8 8 8 0 8 8 8 0 8 0 8 0 8 8 8 8 8
0 0 0 0 8 0 22 0 22 0 8 0 8 0 22 0 22 0 22 0 22 0 8 0 8 0 22 0 22 0 22 0 0 0 0 0 22 0 8 0 8 0 22 0 22 0 22 0 22 0 22 0 22 0 8 0 8 0 8 0 0 0 0
0 0 0 0 8 0 8 8 8 0 8 0 8 0 8 8 8 0 8 8 8 0 8 22 8 0 8 8 8 0 8 8 8 22 8 8 8 0 8 22 8 0 8 8 8 0 8 8 8 0 8 8 8 0 8 22 8 0 8 0 0 0 0
0 0 0 0 8 0 0 0 0 0 22 0 22 0 0 0 0 0 0 0 0 0 0 0 0 0 0 0 0 0 0 0 0 0 0 0 0 0 0 0 0 0 0 0 0 0 0 0 0 0 0 0 0 0 0 0 0 0 8 0 0 0 0
0 0 0 0 8 8 8 8 8 0 8 0 8 0 8 8 8 0 8 8 8 0 8 8 8 0 8 8 8 0 8 8 8 22 8 8 8 0 8 22 8 0 8 22 8 0 8 8 8 0 8 8 8 0 8 8 8 8 8 0 0 0 0
0 0 0 0 0 0 0 0 8 0 8 0 8 0 22 0 22 0 22 0 22 0 22 0 22 0 22 0 22 0 8 0 0 0 0 0 8 0 8 22 8 0 8 0 8 0 22 0 22 0 22 0 22 0 8 0 0 0 0 0 0 0 0
0 0 0 0 0 0 0 0 8 0 8 22 8 0 8 8 8 0 8 8 8 0 8 8 8 0 8 8 8 0 8 0 0 0 0 0 8 0 0 0 0 0 8 0 8 0 8 8 8 0 8 8 8 0 8 0 0 0 0 0 0 0 0
0 0 0 0 0 0 0 0 8 0 0 0 0 0 0 0 0 0 0 0 0 0 0 0 0 0 0 0 0 0 22 0 0 0 8 8 8 0 8 22 8 0 22 0 22 0 0 0 0 0 0 0 0 0 8 0 0 0 0 0 0 0 0
0 0 0 0 0 0 0 0 8 8 8 8 8 0 8 8 8 0 8 8 8 22 8 8 8 0 8 8 8 0 8 0 0 0 8 0 10 0 8 0 8 0 8 0 8 0 8 8 8 0 8 8 8 8 8 0 0 0 0 0 0 0 0
0 0 0 0 0 0 0 0 0 0 0 0 8 0 22 0 22 0 22 0 0 0 0 0 22 0 22 0 22 0 8 0 0 0 8 8 8 0 8 0 8 0 8 0 8 0 22 0 22 0 8 0 0 0 0 0 0 0 0 0 0 0 0
0 0 0 0 0 0 0 0 0 0 0 0 8 0 8 8 8 0 8 8 8 22 8 8 8 0 8 8 8 0 8 8 8 22 8 8 8 0 8 22 8 0 8 22 8 0 8 8 8 0 8 0 0 0 0 0 0 0 0 0 0 0 0
0 0 0 0 0 0 0 0 0 0 0 0 8 0 0 0 0 0 0 0 0 0 0 0 0 0 0 0 0 0 0 0 0 0 0 0 0 0 0 0 0 0 0 0 0 0 0 0 0 0 8 0 0 0 0 0 0 0 0 0 0 0 0
0 0 0 0 0 0 0 0 0 0 0 0 8 8 8 8 8 0 8 8 8 0 8 8 8 0 8 8 8 22 8 8 8 0 8 8 8 0 8 8 8 0 8 8 8 0 8 8 8 8 8 0 0 0 0 0 0 0 0 0 0 0 0
0 0 0 0 0 0 0 0 0 0 0 0 0 0 0 0 8 0 22 0 22 0 22 0 22 0 22 0 0 0 0 0 22 0 22 0 22 0 22 0 22 0 22 0 22 0 8 0 0 0 0 0 0 0 0 0 0 0 0 0 0 0 0
0 0 0 0 0 0 0 0 0 0 0 0 0 0 0 0 8 0 8 8 8 0 8 8 8 0 8 8 8 22 8 8 8 0 8 8 8 0 8 8 8 0 8 8 8 0 8 0 0 0 0 0 0 0 0 0 0 0 0 0 0 0 0
0 0 0 0 0 0 0 0 0 0 0 0 0 0 0 0 8 0 0 0 0 0 0 0 0 0 0 0 0 0 0 0 0 0 0 0 0 0 0 0 0 0 0 0 0 0 8 0 0 0 0 0 0 0 0 0 0 0 0 0 0 0 0
0 0 0 0 0 0 0 0 0 0 0 0 0 0 0 0 8 8 8 8 8 0 8 8 8 0 8 22 8 0 8 8 8 0 8 8 8 22 8 8 8 0 8 8 8 8 8 0 0 0 0 0 0 0 0 0 0 0 0 0 0 0 0
0 0 0 0 0 0 0 0 0 0 0 0 0 0 0 0 0 0 0 0 8 0 22 0 22 0 8 0 8 0 22 0 22 0 22 0 0 0 0 0 22 0 8 0 0 0 0 0 0 0 0 0 0 0 0 0 0 0 0 0 0 0 0
0 0 0 0 0 0 0 0 0 0 0 0 0 0 0 0 0 0 0 0 8 0 8 8 8 0 8 0 8 0 8 8 8 0 8 8 8 22 8 8 8 0 8 0 0 0 0 0 0 0 0 0 0 0 0 0 0 0 0 0 0 0 0
0 0 0 0 0 0 0 0 0 0 0 0 0 0 0 0 0 0 0 0 8 0 0 0 0 0 22 0 22 0 0 0 0 0 0 0 0 0 0 0 0 0 8 0 0 0 0 0 0 0 0 0 0 0 0 0 0 0 0 0 0 0 0
0 0 0 0 0 0 0 0 0 0 0 0 0 0 0 0 0 0 0 0 8 8 8 8 8 0 8 0 8 0 8 8 8 0 8 8 8 0 8 8 8 8 8 0 0 0 0 0 0 0 0 0 0 0 0 0 0 0 0 0 0 0 0
0 0 0 0 0 0 0 0 0 0 0 0 0 0 0 0 0 0 0 0 0 0 0 0 8 0 8 0 8 0 22 0 22 0 22 0 22 0 8 0 0 0 0 0 0 0 0 0 0 0 0 0 0 0 0 0 0 0 0 0 0 0 0
0 0 0 0 0 0 0 0 0 0 0 0 0 0 0 0 0 0 0 0 0 0 0 0 8 0 8 22 8 0 8 8 8 0 8 8 8 0 8 0 0 0 0 0 0 0 0 0 0 0 0 0 0 0 0 0 0 0 0 0 0 0 0
0 0 0 0 0 0 0 0 0 0 0 0 0 0 0 0 0 0 0 0 0 0 0 0 8 0 0 0 0 0 0 0 0 0 0 0 0 0 8 0 0 0 0 0 0 0 0 0 0 0 0 0 0 0 0 0 0 0 0 0 0 0 0
0 0 0 0 0 0 0 0 0 0 0 0 0 0 0 0 0 0 0 0 0 0 0 0 8 8 8 8 8 8 8 8 8 8 8 8 8 8 8 0 0 0 0 0 0 0 0 0 0 0 0 0 0 0 0 0 0 0 0 0 0 0 0