6 6 6 6 6 6 6 6 6 6 6 0 0 0 6 6 6 6 6 6 6 6 6 6 6 6 6 0 0 0 0 6 6 6 6 6 6 6 6 6 6 6 6 6 6 6 6 6 6 6 6 6 6 6 6 6 6 6 6 6 6 6
6 0 0 0 0 0 0 0 0 0 6 0 0 0 6 0 0 0 0 0 0 0 0 0 0 0 6 0 0 0 0 6 0 0 0 0 0 0 0 0 0 0 0 0 0 0 0 0 0 0 0 0 0 0 0 0 0 0 0 0 0 6
6 0 6 6 6 6 6 6 6 0 6 6 6 6 6 0 6 6 6 6 6 6 6 6 6 0 6 0 0 0 0 6 0 6 6 6 6 6 6 6 6 6 6 6 6 6 6 6 6 6 6 6 6 6 6 6 6 6 6 6 0 6
6 0 0 0 0 0 0 6 6 0 0 0 0 0 0 0 6 0 0 0 0 0 0 0 6 0 6 6 6 6 6 6 0 6 0 0 0 0 0 0 0 6 6 6 6 6 6 6 6 6 6 6 6 6 6 6 6 6 0 6 0 6
6 6 6 6 6 6 0 6 6 6 6 6 6 6 6 6 6 6 6 6 0 6 6 6 6 0 6 6 0 0 0 0 0 6 0 0 0 0 0 0 0 6 0 0 0 0 0 0 0 0 0 0 0 0 0 0 0 6 0 6 0 6
0 0 6 0 0 0 0 6 6 0 0 0 0 0 0 0 0 0 0 6 0 6 0 0 0 0 6 6 0 6 6 6 6 6 0 0 0 0 0 0 0 6 0 6 6 6 6 6 6 6 6 6 6 6 6 6 0 6 0 6 0 6
0 0 6 0 6 6 6 6 6 0 6 6 6 6 6 6 6 6 0 6 0 6 0 6 6 6 6 6 0 6 0 0 0 6 6 6 6 6 0 6 0 6 0 6 6 6 6 6 6 6 6 6 0 0 6 6 0 6 0 6 0 6
0 0 6 0 6 6 6 6 6 0 6 0 0 6 6 6 6 6 9 6 6 6 0 6 0 0 0 6 0 6 0 0 0 6 0 0 0 6 0 6 0 6 0 0 0 0 0 0 0 0 0 6 0 0 6 0 0 6 0 6 0 6
0 0 6 0 0 0 0 0 0 0 6 0 0 6 0 0 0 0 0 0 6 6 0 6 6 6 6 6 0 6 0 0 0 6 0 0 0 6 6 6 6 6 6 6 6 6 6 6 6 6 0 6 0 0 6 0 6 6 0 6 0 6
0 0 6 6 6 6 6 6 6 6 6 0 0 6 0 0 0 0 0 0 6 6 0 0 0 0 0 0 0 6 6 6 6 6 0 0 0 0 0 0 6 0 0 0 0 0 0 0 0 6 0 6 0 0 6 0 6 6 6 6 0 6
6 6 6 6 6 6 0 0 0 0 0 0 0 6 0 0 0 0 0 0 6 6 6 6 6 6 6 6 6 6 6 0 0 9 0 0 0 0 0 0 6 6 6 0 0 0 0 0 0 6 0 6 0 0 6 0 0 0 0 0 0 6
6 0 0 0 0 6 0 0 0 0 0 0 0 6 0 0 0 0 0 0 6 0 0 0 0 0 0 0 0 0 6 0 0 6 0 0 0 0 0 0 0 0 6 0 0 0 6 6 6 6 0 6 0 0 6 6 6 6 6 6 6 6
6 0 0 0 0 6 6 6 6 6 6 6 6 6 0 0 0 0 0 0 6 0 0 0 0 0 0 0 0 0 6 0 0 6 6 6 6 0 0 0 0 0 6 6 6 6 6 0 0 0 0 6 6 6 6 6 6 6 6 6 0 0
6 0 0 0 0 6 0 0 0 0 0 0 0 0 0 0 0 6 6 6 6 0 0 0 0 0 0 0 0 0 6 0 0 6 0 0 6 0 0 0 0 0 9 0 0 6 6 0 6 6 6 6 0 0 0 0 0 0 0 6 0 0
6 7 6 6 6 6 0 0 0 0 0 0 0 0 0 0 0 6 0 0 0 0 0 0 0 0 0 0 0 0 6 0 0 6 0 0 6 6 6 6 6 6 6 0 0 6 6 0 0 0 0 0 0 0 0 0 0 0 0 6 0 0
6 0 0 0 0 6 0 0 6 6 6 6 6 6 6 6 6 6 0 6 6 6 6 6 6 6 6 6 6 6 6 0 0 6 0 0 0 0 0 0 0 0 6 0 0 6 6 6 6 6 6 6 0 0 0 0 0 0 0 6 0 0
6 0 0 0 0 6 0 0 6 0 0 0 0 0 0 0 0 0 0 6 0 0 0 0 0 0 0 0 0 0 0 0 0 6 0 0 0 0 0 0 0 0 6 0 0 0 0 0 0 0 6 6 0 0 0 0 0 0 0 6 0 0
6 0 0 0 0 6 0 0 6 0 0 0 0 0 0 0 0 0 0 6 0 0 0 0 0 0 0 0 0 0 0 0 0 6 0 0 0 0 0 0 0 0 6 0 0 0 0 0 0 0 6 6 0 0 0 0 0 0 0 6 0 0
6 0 0 0 0 6 0 0 6 6 6 6 0 0 0 0 0 0 0 6 0 0 6 6 6 7 6 6 6 6 6 6 6 6 6 6 6 6 6 0 0 0 6 6 6 6 6 6 6 7 6 6 0 0 0 0 0 0 0 6 0 0
6 0 0 0 0 6 0 0 0 0 0 6 0 0 0 0 6 6 6 6 0 0 6 0 0 7 0 0 6 0 0 0 0 0 0 0 0 0 6 6 6 0 0 0 0 0 6 0 0 7 0 0 0 0 0 0 0 0 0 6 0 0
6 0 6 6 9 6 0 0 0 0 0 6 0 0 0 0 6 0 0 7 0 0 6 6 0 0 0 6 6 0 0 0 0 0 0 0 0 0 10 0 6 0 0 0 0 0 6 6 6 6 0 0 0 0 0 0 0 0 0 6 0 0
6 0 6 0 0 6 0 0 0 0 0 6 0 0 0 0 6 6 6 7 6 6 6 6 0 0 0 6 6 6 6 6 6 0 0 0 0 0 6 6 6 0 0 0 0 0 0 0 0 6 0 0 0 0 0 0 0 0 0 6 0 0
6 0 6 0 0 6 0 0 0 0 0 6 6 6 6 6 6 0 6 0 0 0 0 0 0 0 0 0 0 0 0 0 9 0 0 0 0 0 6 6 6 6 0 0 0 0 0 0 0 6 6 6 6 6 6 6 6 6 6 6 0 0
6 0 9 0 0 6 0 0 0 0 0 0 0 0 0 0 6 0 6 0 0 0 0 0 0 0 0 0 0 0 0 0 6 0 0 0 0 0 6 0 0 6 0 0 0 0 0 0 0 0 0 0 0 0 0 0 0 0 0 0 0 0
6 0 6 0 0 6 6 6 6 6 0 0 0 0 0 0 6 0 6 6 0 0 0 0 0 0 0 0 0 0 0 6 6 6 6 6 6 6 6 0 0 6 0 0 0 0 0 0 0 0 0 0 0 0 0 0 0 0 0 0 0 0
6 6 6 0 0 6 0 0 0 6 0 0 0 0 0 0 6 0 6 0 0 0 6 6 6 6 6 6 6 0 0 0 6 0 0 0 0 0 6 0 0 6 0 0 6 6 6 6 6 6 6 6 0 0 0 0 0 0 0 0 0 0
6 0 0 0 0 6 0 0 0 6 6 6 6 6 9 6 6 6 6 0 0 0 6 6 6 6 6 6 6 0 0 0 6 6 6 6 0 0 7 0 0 6 0 0 6 0 0 0 0 0 0 6 0 0 0 0 0 0 0 0 0 0
6 0 0 0 0 6 0 0 0 0 0 0 6 6 0 6 0 0 0 0 0 0 6 6 0 0 0 6 0 0 0 0 0 0 0 6 0 0 6 6 6 6 0 0 6 0 0 0 0 0 0 6 0 0 0 0 0 0 0 0 0 0
6 0 0 6 6 6 0 0 0 0 0 0 6 0 0 7 0 0 0 0 0 0 6 11 0 X 0 9 0 0 0 0 0 0 0 7 0 0 6 0 0 6 6 6 6 0 0 0 0 0 0 6 0 0 0 0 0 0 0 0 0 0
6 0 0 6 0 0 0 0 0 0 0 0 6 6 0 6 0 0 0 0 0 0 6 6 0 0 0 6 0 0 0 0 0 0 0 6 0 0 6 0 0 6 0 0 9 0 0 0 0 6 6 6 0 0 0 0 0 0 0 0 0 0
6 0 0 6 0 0 0 0 0 0 0 6 6 6 9 6 6 6 6 0 0 0 6 6 6 6 6 6 6 0 0 0 6 6 6 6 0 0 6 0 0 6 0 0 6 0 0 0 6 6 0 0 0 0 0 0 0 0 0 0 0 0
6 0 0 6 0 0 0 0 0 0 0 6 0 0 0 0 6 0 6 0 0 0 6 6 6 6 6 6 6 0 0 0 6 0 0 6 0 0 6 0 0 6 0 0 6 0 0 0 6 0 0 0 0 0 0 0 0 0 0 0 0 0
6 0 0 6 0 0 0 0 0 6 6 6 0 0 0 0 6 0 6 6 0 0 0 0 0 0 0 0 0 0 0 6 6 6 6 6 0 0 6 6 6 6 0 0 6 6 6 6 6 0 0 0 0 0 0 0 0 0 0 0 0 0
6 0 0 6 0 0 0 0 0 6 0 0 0 0 0 0 6 0 6 0 0 0 0 0 0 0 0 0 0 0 0 0 6 6 0 0 0 0 0 0 0 0 0 0 6 0 0 0 0 0 0 0 0 0 0 0 0 0 0 0 0 0
6 0 0 6 6 6 6 6 6 6 0 0 0 0 0 0 6 0 6 0 0 0 0 0 0 0 0 0 0 0 0 0 6 6 0 0 0 0 0 0 0 0 0 0 6 0 0 0 0 0 0 0 0 0 0 0 0 0 0 0 0 0
6 0 0 0 0 0 0 0 0 0 0 0 0 0 6 6 6 0 6 6 6 6 6 6 0 0 0 6 6 6 6 6 6 6 0 0 6 6 6 6 6 6 6 6 6 0 0 0 0 0 0 0 0 0 0 0 0 0 0 0 0 0
6 0 0 0 0 0 0 0 0 0 0 0 0 0 6 0 0 0 0 0 0 0 0 6 0 0 0 6 0 0 0 0 0 6 0 0 6 0 0 0 0 0 0 0 0 0 0 0 0 0 0 0 0 0 0 0 0 0 0 0 0 0
6 6 6 6 6 6 6 6 6 6 6 6 6 6 6 0 0 0 0 0 0 0 0 6 0 0 0 6 0 0 0 0 0 6 0 0 6 0 0 0 0 0 0 0 0 0 0 0 0 0 0 0 0 0 0 0 0 0 0 0 0 0
6 0 0 0 0 0 0 0 0 0 0 0 0 0 0 0 0 0 0 0 0 6 6 6 6 7 6 6 0 0 0 0 0 6 0 0 6 0 0 0 0 0 0 0 0 0 0 0 0 0 0 0 0 0 0 0 0 0 0 0 0 0
6 0 0 0 0 0 0 0 0 0 0 0 0 0 0 0 0 0 0 0 0 6 0 0 0 0 0 6 0 0 0 0 0 6 6 9 6 6 6 6 6 0 0 0 0 0 0 0 0 0 0 0 0 0 0 0 0 0 0 0 0 0
6 0 0 0 0 0 0 0 0 0 0 0 0 0 0 0 0 0 0 0 0 6 0 0 0 0 0 6 0 0 0 0 0 6 0 0 0 0 0 0 6 0 0 0 0 0 0 0 0 0 0 0 0 0 0 0 0 0 0 0 0 0
6 0 0 0 0 0 0 0 0 0 0 0 0 0 0 0 0 0 0 0 0 6 0 0 6 6 6 6 0 0 0 0 0 6 0 0 0 0 0 0 6 0 0 0 0 0 0 0 0 0 0 0 0 0 0 0 0 0 0 0 0 0
6 0 0 0 0 0 0 0 0 0 0 0 0 0 0 0 0 0 0 0 0 6 0 0 6 0 0 0 0 0 0 0 0 6 0 0 0 0 0 0 6 6 0 0 0 0 0 0 0 0 0 0 0 0 0 0 0 0 0 0 0 0
6 0 0 0 0 0 0 0 0 0 0 0 0 0 0 0 0 0 0 0 0 6 0 0 6 0 0 0 0 0 0 0 0 6 6 6 6 0 0 0 0 6 0 0 0 0 0 0 0 0 0 0 0 0 0 0 0 0 0 0 0 0
6 0 0 0 0 0 0 0 0 0 0 0 0 0 0 0 0 6 6 6 6 6 0 0 6 6 6 0 0 0 0 0 0 0 0 0 6 0 0 0 0 6 0 0 0 0 0 0 0 0 0 0 0 0 0 0 0 0 0 0 0 0
6 0 0 0 0 0 0 0 0 0 0 0 0 0 0 0 0 6 0 0 0 0 0 0 0 0 6 0 0 0 0 0 0 0 0 0 6 6 6 0 0 6 0 0 0 0 0 0 0 0 0 0 0 0 0 0 0 0 0 0 0 0
6 0 0 0 0 0 0 0 0 0 0 0 0 0 0 0 0 6 0 0 0 0 0 0 0 0 6 0 0 0 0 6 6 6 6 6 6 6 6 0 0 6 0 0 0 0 0 0 0 0 0 0 0 0 0 0 0 0 0 0 0 0
6 0 0 0 0 0 0 0 0 0 0 0 0 0 0 0 0 6 0 0 6 6 6 6 6 6 6 0 0 0 0 6 0 0 0 0 0 0 0 0 0 6 0 0 0 0 0 0 0 0 0 0 0 0 0 0 0 0 0 0 0 0
6 0 0 0 0 0 0 0 0 6 6 6 6 6 6 6 6 6 0 0 6 0 0 0 0 0 0 0 0 0 0 6 0 0 0 0 0 0 0 0 0 6 0 0 0 0 0 0 0 0 0 0 0 0 0 0 0 0 0 0 0 0
6 0 0 0 0 0 0 0 0 6 0 0 0 0 0 0 0 6 0 0 6 0 0 0 0 0 0 0 0 0 0 6 0 0 0 0 0 0 0 0 0 6 0 0 0 0 0 0 0 0 0 0 0 0 0 0 0 0 0 0 0 0
6 0 0 0 0 0 0 0 0 6 0 0 0 0 0 0 0 6 0 0 6 0 0 0 0 0 0 0 0 0 0 6 6 6 6 6 6 6 6 6 6 6 0 0 0 0 0 0 0 0 0 0 0 0 0 0 0 0 0 0 0 0
6 0 0 0 0 0 0 0 0 6 0 0 0 0 0 0 0 6 0 0 6 0 0 0 0 0 0 0 0 0 0 0 0 0 0 0 0 0 0 0 0 0 0 0 0 0 0 0 0 0 0 0 0 0 0 0 0 0 0 0 0 0
6 0 0 0 0 0 0 0 0 6 0 0 0 6 6 6 9 6 0 0 6 6 6 0 0 0 0 0 0 0 0 0 0 0 0 0 0 0 0 0 0 0 0 0 0 0 0 0 0 0 0 0 0 0 0 0 0 0 0 0 0 0
6 0 0 0 0 6 6 6 6 6 0 0 0 6 0 6 0 0 0 0 0 0 6 0 0 0 0 0 0 0 0 0 0 0 0 0 0 0 0 0 0 0 0 0 0 0 0 0 0 0 0 0 0 0 0 0 0 0 0 0 0 0
6 0 0 0 0 6 0 0 0 0 0 0 0 6 0 6 0 0 0 0 0 0 6 0 0 0 0 0 0 0 6 6 6 6 6 0 0 0 0 0 0 0 0 0 0 0 0 0 0 0 0 0 0 0 0 0 0 0 0 0 0 0
6 0 0 0 0 6 0 0 0 0 0 0 0 6 0 6 6 6 6 6 6 9 6 6 6 6 6 6 6 6 6 0 0 0 6 6 6 6 6 0 0 0 0 0 0 0 0 0 0 0 0 0 0 0 0 0 0 0 0 0 0 0
6 0 0 6 6 6 0 0 0 0 0 0 0 6 0 0 0 0 6 6 0 0 0 0 0 0 0 0 6 6 0 0 0 0 0 7 0 0 6 0 0 0 0 0 0 0 0 0 0 0 0 0 0 0 0 0 0 0 0 0 0 0
6 0 0 6 0 0 0 0 0 0 0 0 0 6 0 0 0 0 6 0 0 0 0 0 0 0 0 0 0 9 0 0 0 0 0 6 0 0 6 0 0 0 0 0 0 0 0 0 0 0 0 0 0 0 0 0 0 0 0 0 0 0
6 0 0 6 6 6 0 0 0 0 0 0 0 6 0 0 0 0 6 0 0 0 0 0 0 0 0 0 0 6 0 0 0 0 0 6 0 0 6 0 0 0 0 0 0 0 0 0 0 0 0 0 0 0 0 0 0 0 0 0 0 0
6 0 0 0 0 6 0 0 0 0 0 0 0 6 0 0 0 0 6 0 0 0 0 0 0 0 0 0 0 6 0 0 0 0 0 6 0 0 6 0 0 0 0 0 0 0 0 0 0 0 0 0 0 0 0 0 0 0 0 0 0 0
6 0 0 0 0 6 0 0 0 0 0 0 0 6 0 0 0 0 6 0 0 0 0 0 0 0 0 0 0 9 0 0 0 0 0 6 0 0 6 0 0 0 0 0 0 0 0 0 0 0 0 0 0 0 0 0 0 0 0 0 0 0
6 0 0 0 0 6 6 6 6 0 6 6 6 6 0 0 0 0 6 6 0 0 0 0 0 0 0 0 6 6 0 0 0 0 0 6 0 0 6 0 0 0 0 0 0 0 0 0 0 0 0 0 0 0 0 0 0 0 0 0 0 0
6 0 0 0 0 0 0 0 6 0 6 0 0 0 0 0 0 0 0 6 6 6 6 6 6 6 6 6 6 6 6 0 0 0 6 6 0 0 6 0 0 0 0 0 0 0 0 0 0 0 0 0 0 0 0 0 0 0 0 0 0 0
6 0 0 0 0 0 0 0 6 6 6 0 0 0 0 0 0 0 0 0 0 0 0 0 0 0 0 0 0 0 6 6 6 6 6 6 6 6 6 0 0 0 0 0 0 0 0 0 0 0 0 0 0 0 0 0 0 0 0 0 0 0