0 0 0 0 0 0 0 0 0 0 0 0 0 0 0 0 6 6 6 20 6 6 6 0 0 0 0 0 0 0 0 0 0 0 0 0 0 0 0
0 0 0 0 0 3 3 3 3 3 3 3 3 3 3 3 6 0 0 0 0 0 6 3 3 3 3 3 3 3 3 3 3 3 0 0 0 0 0
0 0 0 0 0 3 0 0 0 0 0 0 0 0 0 0 6 0 0 0 0 0 6 0 0 0 0 0 0 0 0 0 0 3 0 0 0 0 0
0 0 0 0 0 17 0 0 0 0 0 0 0 0 0 0 9 0 0 0 0 0 9 0 0 0 0 0 0 0 0 0 0 17 0 0 0 0 0
0 0 0 0 0 3 0 0 0 0 0 0 0 0 0 0 6 0 0 0 0 0 6 0 0 0 0 0 0 0 0 0 0 3 0 0 0 0 0
0 3 3 17 3 1 15 9 15 1 1 1 1 1 1 1 6 0 0 0 0 0 6 1 1 1 1 1 1 1 15 9 15 1 3 17 3 3 0
0 3 0 0 0 14 0 0 0 0 0 0 0 1 1 1 6 6 6 9 6 6 6 0 0 1 0 0 0 0 0 0 0 14 0 0 0 3 0
0 3 0 0 0 9 0 0 0 0 0 0 0 1 0 0 1 3 0 0 0 3 0 0 0 1 0 0 0 0 0 0 0 9 0 0 0 3 0
0 3 0 0 0 14 0 0 0 0 0 0 0 1 0 0 1 3 0 0 0 3 0 0 0 1 0 0 0 0 0 0 0 14 0 0 0 3 0
0 3 0 0 0 1 0 0 0 0 0 0 0 1 0 0 1 3 0 0 0 3 0 0 0 1 0 0 0 0 0 0 0 1 0 0 0 3 0
0 3 0 0 0 1 1 1 1 1 1 18 1 1 0 0 1 16 0 0 0 16 0 0 3 1 1 18 1 1 1 1 1 1 0 0 0 3 0
0 3 0 0 0 3 0 0 0 0 0 0 0 0 0 0 1 3 0 0 0 3 0 0 1 0 0 0 0 0 0 1 0 3 0 0 0 3 0
0 3 0 0 0 3 0 0 0 0 0 0 0 0 0 0 1 3 0 0 0 3 0 0 1 0 0 0 0 0 0 1 0 3 0 0 0 3 0
0 3 0 0 0 3 0 0 0 0 0 0 0 0 0 0 1 3 0 0 0 3 0 0 1 0 0 0 0 0 0 1 0 3 0 0 0 3 0
0 3 0 0 0 3 1 1 1 1 1 1 1 1 1 1 1 3 0 0 0 3 0 0 1 0 0 0 0 0 0 1 0 3 0 0 0 3 0
0 3 0 0 0 3 0 0 0 0 0 0 0 0 0 3 3 3 19 9 19 3 3 3 1 0 0 0 0 0 0 1 0 3 0 0 0 3 0
6 6 6 9 6 6 6 0 0 0 0 0 0 0 0 3 0 0 0 0 0 0 0 3 1 1 1 1 1 1 1 1 6 6 6 9 6 6 6
6 0 0 0 0 0 6 3 3 16 3 3 3 3 3 3 0 0 0 0 0 0 0 3 3 3 3 3 16 3 3 3 6 0 0 0 0 0 6
6 0 0 0 0 0 6 0 0 0 0 0 0 0 0 20 0 0 6 6 6 0 0 20 0 0 0 0 0 0 0 0 6 0 0 0 0 0 6
19 0 0 0 0 0 9 0 0 0 0 0 0 0 0 9 0 0 6 11 6 0 0 9 0 0 0 0 0 0 0 0 9 0 0 0 0 0 19
6 0 0 0 0 0 6 0 0 0 0 0 0 0 0 20 0 0 0 0 0 0 0 20 0 0 0 0 0 0 0 0 6 0 0 0 0 0 6
6 0 0 0 0 0 6 3 3 3 3 3 3 3 3 3 0 0 0 X 0 0 0 3 3 3 3 3 3 3 3 3 6 0 0 0 0 0 6
6 6 6 9 6 6 6 0 0 0 0 0 0 0 0 3 0 0 0 0 0 0 0 3 1 1 1 1 1 1 1 1 6 6 6 9 6 6 6
0 3 0 0 0 3 0 1 1 1 1 1 1 1 1 3 3 3 19 9 19 3 3 3 1 0 0 0 0 0 0 0 1 3 0 0 0 3 0
0 3 0 0 0 3 0 1 0 0 0 0 0 0 1 0 0 3 0 0 0 3 0 1 0 0 0 0 0 0 0 0 1 3 0 0 0 3 0
0 3 0 0 0 3 0 1 0 0 0 0 0 0 1 0 0 3 0 0 0 3 0 1 0 0 0 0 0 0 0 0 1 3 0 0 0 3 0
0 3 0 0 0 3 0 1 0 0 0 0 0 0 1 0 0 3 0 0 0 3 0 1 0 0 0 0 0 0 0 0 1 3 0 0 0 3 0
0 3 0 0 0 3 0 1 0 0 0 0 0 0 1 0 0 3 0 0 0 3 0 1 0 0 0 0 0 0 0 0 1 3 0 0 0 3 0
0 3 0 0 0 3 0 1 0 0 0 0 0 0 1 0 0 16 0 0 0 3 0 1 0 0 0 0 0 0 0 0 1 3 0 0 0 3 0
0 3 0 0 0 3 1 1 1 1 1 18 1 1 1 0 0 3 0 0 0 3 0 3 1 1 1 18 1 1 1 1 1 1 0 0 0 3 0
0 3 0 0 0 3 0 0 0 0 0 0 0 0 1 3 3 3 0 0 0 3 0 0 0 0 0 0 0 0 0 0 0 1 0 0 0 3 0
0 3 0 0 0 3 0 0 0 0 0 0 0 0 10 0 3 3 0 0 0 3 0 0 0 0 0 0 0 0 0 0 0 14 0 0 0 3 0
0 3 0 0 0 3 0 0 0 0 0 0 0 0 1 3 3 3 0 0 0 3 0 0 0 0 0 0 0 0 0 0 0 9 0 0 0 3 0
0 3 0 0 0 3 0 0 0 0 0 0 0 0 1 0 6 6 6 9 6 6 6 0 0 0 0 0 0 0 0 0 0 14 0 0 0 3 0
0 3 3 17 3 1 15 9 15 1 1 1 1 1 1 1 6 0 0 0 0 0 6 1 1 1 1 1 1 1 15 9 15 1 3 17 3 3 0
0 0 0 0 0 3 0 0 0 0 0 0 0 0 0 0 6 0 0 0 0 0 6 0 0 0 0 0 0 0 0 0 0 3 0 0 0 0 0
0 0 0 0 0 17 0 0 0 0 0 0 0 0 0 0 9 0 0 0 0 0 9 0 0 0 0 0 0 0 0 0 0 17 0 0 0 0 0
0 0 0 0 0 3 0 0 0 0 0 0 0 0 0 0 6 0 0 0 0 0 6 0 0 0 0 0 0 0 0 0 0 3 0 0 0 0 0
0 0 0 0 0 3 3 3 3 3 3 3 3 3 3 3 6 0 0 0 0 0 6 3 3 3 3 3 3 3 3 3 3 3 0 0 0 0 0
0 0 0 0 0 0 0 0 0 0 0 0 0 0 0 0 6 6 6 20 6 6 6 0 0 0 0 0 0 0 0 0 0 0 0 0 0 0 0