0 0 0 0 0 0 0 0 0 0 0 0 0 0 0 0 0 0 0 0 0 0 0 0 0 0 0 0 0 0 0 0 0 0 0 8 8 8 8 8 8 8 8 8 8 8 8 8 0 0 0 0 0 0 0 0 0 0 0 0 0 0 0
0 0 0 0 0 0 0 0 0 0 0 0 0 0 0 0 0 0 0 0 0 0 0 0 0 0 0 0 0 0 0 0 0 0 8 8 0 0 0 0 0 0 0 0 0 0 0 8 0 0 0 0 0 0 0 0 0 0 0 0 0 0 0
0 0 0 0 0 0 0 0 0 0 0 0 0 0 0 0 0 0 0 0 0 0 0 0 0 0 0 0 0 0 0 0 0 0 8 0 0 0 0 0 0 0 0 0 0 0 0 8 0 0 0 0 0 0 0 0 0 0 0 0 0 0 0
0 0 0 0 0 0 0 0 0 0 0 0 0 0 0 0 0 0 0 0 0 0 0 0 0 0 0 0 0 0 0 0 8 b 8 0 0 0 0 0 0 0 0 0 0 0 0 8 0 0 0 0 0 0 0 0 0 0 0 0 0 0 0
0 0 0 0 0 0 0 0 0 0 0 0 0 0 0 0 0 0 0 0 0 0 0 0 0 0 0 0 8 8 8 8 8 X 8 a 8 8 8 8 8 8 8 8 8 8 8 8 0 0 0 0 0 0 0 0 0 0 0 0 0 0 0
0 0 0 0 0 0 0 0 0 0 0 0 0 0 0 0 0 0 0 0 0 0 0 0 0 0 0 0 8 0 0 0 0 0 0 0 0 0 8 0 0 0 0 0 0 0 0 0 0 0 0 0 0 0 0 0 0 0 0 0 0 0 0
0 0 0 0 0 0 0 0 0 0 0 0 0 0 0 0 0 0 0 0 0 0 0 0 0 0 0 0 8 0 8 8 8 0 8 8 8 0 8 0 0 0 0 0 0 0 0 0 0 0 0 0 0 0 0 0 0 0 0 0 0 0 0
0 0 0 0 0 0 0 0 0 0 0 0 0 0 0 0 0 0 0 0 0 0 0 0 0 0 0 0 8 0 c 0 c 0 c 0 c 0 8 0 0 0 0 0 0 0 0 0 0 0 0 0 0 0 0 0 0 0 0 0 0 0 0
0 0 0 0 0 0 0 0 0 0 0 0 0 0 0 0 0 0 0 0 0 0 0 0 8 8 8 8 8 0 8 8 8 0 8 8 8 0 8 8 8 8 8 0 0 0 0 0 0 0 0 0 0 0 0 0 0 0 0 0 0 0 0
0 0 0 0 0 0 0 0 0 0 0 0 0 0 0 0 0 0 0 0 0 0 0 0 8 0 0 0 0 0 0 0 0 0 0 0 0 0 0 0 0 0 8 0 0 0 0 0 0 0 0 0 0 0 0 0 0 0 0 0 0 0 0
0 0 0 0 0 0 0 0 0 0 0 0 0 0 0 0 0 0 0 0 0 0 0 0 8 0 8 8 8 0 8 8 8 c 8 8 8 0 8 8 8 0 8 0 0 0 0 0 0 0 0 0 0 0 0 0 0 0 0 0 0 0 0
0 0 0 0 0 0 0 0 0 0 0 0 0 0 0 0 0 0 0 0 0 0 0 0 8 0 c 0 c 0 c 0 0 0 0 0 c 0 c 0 c 0 8 0 0 0 0 0 0 0 0 0 0 0 0 0 0 0 0 0 0 0 0
0 0 0 0 0 0 0 0 0 0 0 0 0 0 0 0 0 0 0 0 8 8 8 8 8 0 8 8 8 0 8 8 8 c 8 8 8 0 8 8 8 0 8 8 8 8 8 0 0 0 0 0 0 0 0 0 0 0 0 0 0 0 0
0 0 0 0 0 0 0 0 0 0 0 0 0 0 0 0 0 0 0 0 8 0 0 0 0 0 0 0 0 0 0 0 0 0 0 0 0 0 0 0 0 0 0 0 0 0 8 0 0 0 0 0 0 0 0 0 0 0 0 0 0 0 0
0 0 0 0 0 0 0 0 0 0 0 0 0 0 0 0 0 0 0 0 8 0 8 c 8 0 8 8 8 0 8 8 8 0 8 8 8 0 8 8 8 0 8 8 8 0 8 0 0 0 0 0 0 0 0 0 0 0 0 0 0 0 0
0 0 0 0 0 0 0 0 0 0 0 0 0 0 0 0 0 0 0 0 8 0 8 0 8 0 c 0 c 0 c 0 c 0 c 0 c 0 c 0 c 0 c 0 c 0 8 0 0 0 0 0 0 0 0 0 0 0 0 0 0 0 0
0 0 0 0 0 0 0 0 0 0 0 0 0 0 0 0 8 8 8 8 8 0 8 0 8 0 8 8 8 0 8 8 8 0 8 8 8 0 8 8 8 0 8 8 8 0 8 8 8 8 8 0 0 0 0 0 0 0 0 0 0 0 0
0 0 0 0 0 0 0 0 0 0 0 0 0 0 0 0 8 0 0 0 0 0 c 0 c 0 0 0 0 0 0 0 0 0 0 0 0 0 0 0 0 0 0 0 0 0 0 0 0 0 8 0 0 0 0 0 0 0 0 0 0 0 0
0 0 0 0 0 0 0 0 0 0 0 0 0 0 0 0 8 0 8 8 8 0 8 0 8 0 8 8 8 0 8 8 8 0 8 c 8 0 8 8 8 0 8 8 8 0 8 8 8 0 8 0 0 0 0 0 0 0 0 0 0 0 0
0 0 0 0 0 0 0 0 0 0 0 0 0 0 0 0 8 0 c 0 c 0 8 0 8 0 c 0 c 0 c 0 c 0 8 0 8 0 c 0 c 0 c 0 c 0 c 0 c 0 8 0 0 0 0 0 0 0 0 0 0 0 0
0 0 0 0 0 0 0 0 0 0 0 0 8 8 8 8 8 0 8 8 8 0 8 c 8 0 8 8 8 0 8 8 8 0 8 0 8 0 8 8 8 0 8 8 8 0 8 8 8 0 8 8 8 8 8 0 0 0 0 0 0 0 0
0 0 0 0 0 0 0 0 0 0 0 0 8 0 0 0 0 0 0 0 0 0 0 0 0 0 0 0 0 0 0 0 0 0 c 0 c 0 0 0 0 0 0 0 0 0 0 0 0 0 0 0 0 0 8 0 0 0 0 0 0 0 0
0 0 0 0 0 0 0 0 0 0 0 0 8 0 8 8 8 0 8 c 8 0 8 8 8 0 8 8 8 0 8 8 8 0 8 0 8 0 8 8 8 c 8 8 8 0 8 c 8 0 8 8 8 0 8 0 0 0 0 0 0 0 0
0 0 0 0 0 0 0 0 0 0 0 0 8 0 c 0 c 0 8 0 8 0 c 0 c 0 c 0 c 0 c 0 c 0 8 0 8 0 c 0 0 0 0 0 c 0 8 0 8 0 c 0 c 0 8 0 0 0 0 0 0 0 0
0 0 0 0 0 0 0 0 8 8 8 8 8 0 8 8 8 0 8 0 8 0 8 8 8 0 8 8 8 0 8 8 8 0 8 c 8 0 8 8 8 c 8 8 8 0 8 0 8 0 8 8 8 0 8 8 8 8 8 0 0 0 0
0 0 0 0 0 0 0 0 8 0 0 0 0 0 0 0 0 0 c 0 c 0 0 0 0 0 0 0 0 0 0 0 0 0 0 0 0 0 0 0 0 0 0 0 0 0 c 0 c 0 0 0 0 0 0 0 0 0 8 0 0 0 0
0 0 0 0 0 0 0 0 8 0 8 8 8 0 8 8 8 0 8 0 8 0 8 8 8 0 8 8 8 c 8 8 8 0 8 8 8 0 8 8 8 0 8 8 8 0 8 0 8 0 8 8 8 c 8 8 8 0 8 0 0 0 0
0 0 0 0 0 0 0 0 8 0 c 0 c 0 c 0 c 0 8 0 8 0 c 0 c 0 c 0 0 0 0 0 c 0 c 0 c 0 c 0 c 0 c 0 c 0 8 0 8 0 c 0 0 0 0 0 c 0 8 0 0 0 0
0 0 0 0 8 8 8 8 8 0 8 8 8 0 8 8 8 0 8 c 8 0 8 8 8 0 8 8 8 c 8 8 8 0 8 8 8 0 8 8 8 0 8 8 8 0 8 c 8 0 8 8 8 c 8 8 8 0 8 8 8 8 8
0 0 0 0 8 0 0 0 0 0 0 0 0 0 0 0 0 0 0 0 0 0 0 0 0 0 0 0 0 0 0 0 0 0 0 0 0 0 0 0 0 0 0 0 0 0 0 0 0 0 0 0 0 0 0 0 0 0 0 0 0 0 8
0 0 0 0 8 0 8 8 8 0 8 8 8 0 8 8 8 0 8 8 8 0 8 8 8 0 8 8 8 0 8 8 8 0 8 8 8 0 8 8 8 0 8 c 8 0 8 8 8 0 8 8 8 0 8 8 8 0 8 8 8 0 8
0 0 0 0 8 0 c 0 c 0 c 0 c 0 c 0 c 0 c 0 c 0 c 0 c 0 c 0 c 0 c 0 c 0 c 0 c 0 c 0 c 0 8 0 8 0 c 0 c 0 c 0 c 0 c 0 c 0 c 0 c 0 8
8 8 8 8 8 0 8 8 8 0 8 8 8 0 8 8 8 0 8 8 8 0 8 8 8 0 8 8 8 0 8 8 8 0 8 8 8 0 8 8 8 0 8 0 8 0 8 8 8 0 8 8 8 0 8 8 8 0 8 8 8 0 8
8 0 0 0 0 0 0 0 0 0 0 0 0 0 0 0 0 0 0 0 0 0 0 0 0 0 0 0 0 0 0 0 0 0 0 0 0 0 0 0 0 0 c 0 c 0 0 0 0 0 0 0 0 0 0 0 0 0 0 0 0 0 8
8 0 8 8 8 0 8 8 8 c 8 8 8 0 8 8 8 0 8 8 8 0 8 c 8 0 8 8 8 0 8 8 8 0 8 8 8 0 8 c 8 0 8 0 8 0 8 8 8 0 8 8 8 0 8 c 8 0 8 8 8 0 8
8 0 c 0 c 0 c 0 0 0 0 0 c 0 c 0 c 0 c 0 c 0 8 0 8 0 c 0 c 0 c 0 c 0 c 0 c 0 8 0 8 0 8 0 8 0 c 0 c 0 c 0 c 0 8 0 8 0 c 0 c 0 8
8 0 8 8 8 0 8 8 8 c 8 8 8 0 8 8 8 0 8 8 8 0 8 0 8 0 8 8 8 0 8 8 8 0 8 8 8 0 8 0 8 0 8 c 8 0 8 8 8 0 8 8 8 0 8 0 8 0 8 8 8 0 8
8 0 0 0 0 0 0 0 0 0 0 0 0 0 0 0 0 0 0 0 0 0 c 0 c 0 0 0 0 0 0 0 0 0 0 0 0 0 c 0 c 0 0 0 0 0 0 0 0 0 0 0 0 0 c 0 c 0 0 0 0 0 8
8 8 8 8 8 0 8 8 8 0 8 c 8 0 8 8 8 0 8 8 8 0 8 0 8 0 8 8 8 0 8 8 8 c 8 8 8 0 8 0 8 0 8 8 8 0 8 8 8 0 8 8 8 0 8 0 8 0 8 8 8 8 8
0 0 0 0 8 0 c 0 c 0 8 0 8 0 c 0 c 0 c 0 c 0 8 0 8 0 c 0 c 0 c 0 0 0 0 0 c 0 8 0 8 0 c 0 c 0 c 0 c 0 c 0 c 0 8 0 8 0 8 0 0 0 0
0 0 0 0 8 0 8 8 8 0 8 0 8 0 8 8 8 0 8 8 8 0 8 c 8 0 8 8 8 0 8 8 8 c 8 8 8 0 8 c 8 0 8 8 8 0 8 8 8 0 8 8 8 0 8 c 8 0 8 0 0 0 0
0 0 0 0 8 0 0 0 0 0 c 0 c 0 0 0 0 0 0 0 0 0 0 0 0 0 0 0 0 0 0 0 0 0 0 0 0 0 0 0 0 0 0 0 0 0 0 0 0 0 0 0 0 0 0 0 0 0 8 0 0 0 0
0 0 0 0 8 8 8 8 8 0 8 0 8 0 8 8 8 0 8 8 8 0 8 8 8 0 8 8 8 0 8 8 8 c 8 8 8 0 8 c 8 0 8 c 8 0 8 8 8 0 8 8 8 0 8 8 8 8 8 0 0 0 0
0 0 0 0 0 0 0 0 8 0 8 0 8 0 c 0 c 0 c 0 c 0 c 0 c 0 c 0 c 0 8 0 0 0 0 0 8 0 8 c 8 0 8 0 8 0 c 0 c 0 c 0 c 0 8 0 0 0 0 0 0 0 0
0 0 0 0 0 0 0 0 8 0 8 c 8 0 8 8 8 0 8 8 8 0 8 8 8 0 8 8 8 0 8 0 0 0 0 0 8 0 0 0 0 0 8 0 8 0 8 8 8 0 8 8 8 0 8 0 0 0 0 0 0 0 0
0 0 0 0 0 0 0 0 8 0 0 0 0 0 0 0 0 0 0 0 0 0 0 0 0 0 0 0 0 0 c 0 0 0 8 8 8 0 8 c 8 0 c 0 c 0 0 0 0 0 0 0 0 0 8 0 0 0 0 0 0 0 0
0 0 0 0 0 0 0 0 8 8 8 8 8 0 8 8 8 0 8 8 8 c 8 8 8 0 8 8 8 0 8 0 0 0 8 0 d 0 8 0 8 0 8 0 8 0 8 8 8 0 8 8 8 8 8 0 0 0 0 0 0 0 0
0 0 0 0 0 0 0 0 0 0 0 0 8 0 c 0 c 0 c 0 0 0 0 0 c 0 c 0 c 0 8 0 0 0 8 8 8 0 8 0 8 0 8 0 8 0 c 0 c 0 8 0 0 0 0 0 0 0 0 0 0 0 0
0 0 0 0 0 0 0 0 0 0 0 0 8 0 8 8 8 0 8 8 8 c 8 8 8 0 8 8 8 0 8 8 8 c 8 8 8 0 8 c 8 0 8 c 8 0 8 8 8 0 8 0 0 0 0 0 0 0 0 0 0 0 0
0 0 0 0 0 0 0 0 0 0 0 0 8 0 0 0 0 0 0 0 0 0 0 0 0 0 0 0 0 0 0 0 0 0 0 0 0 0 0 0 0 0 0 0 0 0 0 0 0 0 8 0 0 0 0 0 0 0 0 0 0 0 0
0 0 0 0 0 0 0 0 0 0 0 0 8 8 8 8 8 0 0 0 0 0 0 0 0 0 0 0 0 0 0 0 0 0 0 0 0 0 0 0 0 0 0 0 0 0 8 8 8 8 8 0 0 0 0 0 0 0 0 0 0 0 0
0 0 0 0 0 0 0 0 0 0 0 0 0 0 0 0 8 0 0 0 0 0 0 0 0 0 0 0 0 0 0 0 0 0 0 0 0 0 0 0 0 0 0 0 0 0 8 0 0 0 0 0 0 0 0 0 0 0 0 0 0 0 0
0 0 0 0 0 0 0 0 0 0 0 0 0 0 0 0 8 0 0 0 0 0 0 0 0 0 0 0 0 0 0 0 0 0 0 0 0 0 0 0 0 0 0 0 0 0 8 0 0 0 0 0 0 0 0 0 0 0 0 0 0 0 0
0 0 0 0 0 0 0 0 0 0 0 0 0 0 0 0 8 0 0 0 0 0 0 0 0 0 0 0 0 0 0 0 0 0 0 0 0 0 0 0 0 0 0 0 0 0 8 0 0 0 0 0 0 0 0 0 0 0 0 0 0 0 0
0 0 0 0 0 0 0 0 0 0 0 0 0 0 0 0 8 8 8 8 8 0 0 0 0 0 0 0 0 0 0 0 0 0 0 0 0 0 0 0 0 0 8 8 8 8 8 0 0 0 0 0 0 0 0 0 0 0 0 0 0 0 0
0 0 0 0 0 0 0 0 0 0 0 0 0 0 0 0 0 0 0 0 8 0 0 0 0 0 0 0 0 0 0 0 0 0 0 0 0 0 0 0 0 0 8 0 0 0 0 0 0 0 0 0 0 0 0 0 0 0 0 0 0 0 0
0 0 0 0 0 0 0 0 0 0 0 0 0 0 0 0 0 0 0 0 8 0 0 0 0 0 0 0 0 0 0 0 0 0 0 0 0 0 0 0 0 0 8 0 0 0 0 0 0 0 0 0 0 0 0 0 0 0 0 0 0 0 0
0 0 0 0 0 0 0 0 0 0 0 0 0 0 0 0 0 0 0 0 8 0 0 0 0 0 0 0 0 0 0 0 0 0 0 0 0 0 0 0 0 0 8 0 0 0 0 0 0 0 0 0 0 0 0 0 0 0 0 0 0 0 0
0 0 0 0 0 0 0 0 0 0 0 0 0 0 0 0 0 0 0 0 8 8 8 8 8 0 0 0 0 0 0 0 0 0 0 0 0 0 8 8 8 8 8 0 0 0 0 0 0 0 0 0 0 0 0 0 0 0 0 0 0 0 0
0 0 0 0 0 0 0 0 0 0 0 0 0 0 0 0 0 0 0 0 0 0 0 0 8 0 0 0 0 0 0 0 0 0 0 0 0 0 8 0 0 0 0 0 0 0 0 0 0 0 0 0 0 0 0 0 0 0 0 0 0 0 0
0 0 0 0 0 0 0 0 0 0 0 0 0 0 0 0 0 0 0 0 0 0 0 0 8 0 0 0 0 0 0 0 0 0 0 0 0 0 8 0 0 0 0 0 0 0 0 0 0 0 0 0 0 0 0 0 0 0 0 0 0 0 0
0 0 0 0 0 0 0 0 0 0 0 0 0 0 0 0 0 0 0 0 0 0 0 0 8 0 0 0 0 0 0 0 0 0 0 0 0 0 8 0 0 0 0 0 0 0 0 0 0 0 0 0 0 0 0 0 0 0 0 0 0 0 0
0 0 0 0 0 0 0 0 0 0 0 0 0 0 0 0 0 0 0 0 0 0 0 0 8 8 8 8 8 8 8 8 8 8 8 8 8 8 8 0 0 0 0 0 0 0 0 0 0 0 0 0 0 0 0 0 0 0 0 0 0 0 0

a = 18
b = 11
c = 22
d = 10